Test1
An Interactive Fiction by Chad McKinney
Release 1 / Serial number 120501 / Inform 7 build 6G60 (I6/v6.32 lib 6/12N) SD

prison cell
A small light flickers outside, dimly illuminated the cold stone of the cell. A small light flickers outside, dimly illuminated the cold stone of the cell. A small light flickers outside, dimly illuminated the cold stone of the cell. A small light flickers outside, dimly illuminated the cold stone of the cell. A small light flickers outside, dimly illuminated the cold stone of the cell. A small light flickers outside, dimly illuminated the cold stone of the cell. A small light flickers outside, dimly illuminated the cold stone of the cell. A small light flickers outside, dimly illuminated the cold stone of the cell.

>look
prison cell
A small light flickers outside, dimly illuminated the cold stone of the cell. A small light flickers outside, dimly illuminated the cold stone of the cell. A small light flickers outside, dimly illuminated the cold stone of the cell. A small light flickers outside, dimly illuminated the cold stone of the cell. A small light flickers outside, dimly illuminated the cold stone of the cell. A small light flickers outside, dimly illuminated the cold stone of the cell. A small light flickers outside, dimly illuminated the cold stone of the cell. A small light flickers outside, dimly illuminated the cold stone of the cell.

>north
You can't go that way.

>south
You can't go that way.

>east
You can't go that way.

>west
You can't go that way.

>look
prison cell
A small light flickers outside, dimly illuminated the cold stone of the cell. A small light flickers outside, dimly illuminated the cold stone of the cell. A small light flickers outside, dimly illuminated the cold stone of the cell. A small light flickers outside, dimly illuminated the cold stone of the cell. A small light flickers outside, dimly illuminated the cold stone of the cell. A small light flickers outside, dimly illuminated the cold stone of the cell. A small light flickers outside, dimly illuminated the cold stone of the cell. A small light flickers outside, dimly illuminated the cold stone of the cell.

>Egg carton
That's not a verb I recognise.

>look egg carton
You can't see any such thing.

* * *

>north
You can't go that way.

>look north
You see nothing unexpected in that direction.

>look
prison cell
A small light flickers outside, dimly illuminated the cold stone of the cell. A small light flickers outside, dimly illuminated the cold stone of the cell. A small light flickers outside, dimly illuminated the cold stone of the cell. A small light flickers outside, dimly illuminated the cold stone of the cell. A small light flickers outside, dimly illuminated the cold stone of the cell. A small light flickers outside, dimly illuminated the cold stone of the cell. A small light flickers outside, dimly illuminated the cold stone of the cell. A small light flickers outside, dimly illuminated the cold stone of the cell.

>s
You can't go that way.

>north
You can't go that way.

>go south
You can't go that way.

>going south
That's not a verb I recognise.

>s
You can't go that way.

>norht
That's not a verb I recognise.

>east
You can't go that way.

* * *

>west
You can't go that way.

>south
You can't go that way.