Tentacle-laden goat eyes drag themselves on the ground, but you can hardly be bothered t notice.

Radioactive Ruins Hell Bomb Glow
Some things are better kept alive.
Release 1 / Serial number 120502 / Inform v6.32 Library 6/11 SD

Hell
Once you had a dream that a fox named Beezelpup took you under his wing with scorn. Sometimes the mask of acceptance isn't wrong but you forgot your last name. Z-machines dream of electric eels and orange peels. There is a second life in the south.

You can see a Beezelpup and a Black Hole here.

>west
Desert Sand Hour Glass
One grain of sand is worth two opinions on the matter at hand. Once you got a really good deal at a garage sale on some knock off Transformers toys. You didn't mind that they were old, it was the best day of your life, for the day. There is a shelf with several books on it. Most of them are written in retrograde, but one of them is not. Beezelpup says "Have you read 'One Thousand and One Nights'? You should at least read a chapter or two."

You can see a book here. It looks like Andrew Lang's translation of Arabian Nights. The book is long and you could read many chapters: 

One Thousand and One Nights 

Table of Contents 

Introduction 
Chapter 1. The Story of the Merchant and the Genius 
Chapter 2. The Story of the Fisherman 
Chapter 3. Story of the Three Calenders, Sons of Kings, and of Five Ladies of Bagdad 
Chapter 4. The Seven Voyages of Sindbad the Sailor 
Chapter 5. The Little Hunchback 
Chapter 6. The Adventures of Prince Camaralzaman and the Princess Badoura 
Chapter 7. Noureddin and the Fair Persian 
Chapter 8. Aladdin and the Wonderful Lamp 
Chapter 9. The Adventures of Haroun-al-Raschid, Caliph of Bagdad 
Chapter 10. Story of the Blind Baba-Abdalla 
Chapter 11. The Story of Sidi-Nouman 
Chapter 12. Story of Ali Colia, Merchant of Bagdad 
Chapter 13. The Enchanted Horse 
Chapter 14. The Story of Two Sisters Who Were Jealous of Their Younger Sister 
(example: read book chapter 14)

Beezelpup mentions, "I'm going to eat your soul someday, you know."

>read book chapter one
Chapter one 
There's nothing written on that.
Beezelpup says, "You must give up hope."

>read book chapter introduction
I didn't understand that number.

>read book chapter zero
I didn't understand that number.

>read book chapter introduction
I didn't understand that number.

>read book chapter 0
Introduction 
There's nothing written on that.
Beezelpup says, "Sometimes you wish you could die. Well I don't, but you do."

* * *

I beg your pardon?

* * *

>read chapter 1
You can't see any such thing.

* * *

>read chapter 2
You can't see any such thing.

* * *

>read book chapter 1
Chapter one 

The Story of the Merchant and the Genius

 Sire, there was once upon a time a merchant who possessed great wealth, in land and merchandise, as well as in ready money. He was obliged from time to time to take journeys to arrange his affairs. One day, having to go a long way from home, he mounted his horse, taking with him a small wallet in which he had put a few biscuits and dates, because he had to pass through the desert where no food was to be got. He arrived without any mishap, and, having finished his business, set out on his return. On the fourth day of his journey, the heat of the sun being very great, he turned out of his road to rest under some trees. He found at the foot of a large walnut-tree a fountain of clear and running water. He dismounted, fastened his horse to a branch of the tree, and sat by the fountain, after having taken from his wallet some of his dates and biscuits. When he had finished this frugal meal he washed his face and hands in the fountain.

When he was thus employed he saw an enormous genius, white with rage, coming towards him, with a scimitar in his hand.

"Arise," he cried in a terrible voice, "and let me kill you as you have killed my son!"

As he uttered these words he gave a frightful yell. The merchant, quite as much terrified at the hideous face of the monster as at his words, answered him tremblingly, "Alas, good sir, what can I have done to you to deserve death?"

"I shall kill you," repeated the genius, "as you have killed my son."

"But," said the merchant, "How can I have killed your son? I do not know him, and I have never even seen him."

"When you arrived here did you not sit down on the ground?" asked the genius, "and did you not take some dates from your wallet, and whilst eating them did not you throw the stones about?"

"Yes," said the merchant, "I certainly did so."

"Then," said the genius, "I tell you you have killed my son, for whilst you were throwing about the stones, my son passed by, and one of them struck him in the eye and killed him. So I shall kill you."

"Ah, sir, forgive me!" cried the merchant.

"I will have no mercy on you," answered the genius.

"But I killed your son quite unintentionally, so I implore you to spare my life."

"No," said the genius, "I shall kill you as you killed my son," and so saying, he seized the merchant by the arm, threw him on the ground, and lifted his sabre to cut off his head.

 (...) 

Beezelpup says, "You must give up hope."

>read book chapter two
This book doesn' have that chapter. 
There's nothing written on that.
Beezelpup says, "You must give up hope."

>read book chapter 2
This book doesn' have that chapter. 
There's nothing written on that.
Beezelpup says, "You must give up hope."

>read book chapter one
Chapter one 
There's nothing written on that.
Beezelpup falls asleep.

>read book chapter introduction
I didn't understand that number.

* * *

>read book chapter 0
Introduction 
There's nothing written on that.
Beezelpup says, "Sometimes you wish you could die. Well I don't, but you do."

>read book introduction
I only understood you as far as wanting to read the book.

* * *

I beg your pardon?

>read chapter 0
You can't see any such thing.

>read book chapter 0
Introduction 
Beezelpup says, "You must give up hope."

* * *

>read book chapter1
I only understood you as far as wanting to read the book.

>read book chapter 1
This book doesn' have that chapter. 
There's nothing written on that.
Beezelpup falls asleep.

* * *

Tentacle-laden goat eyes drag themselves on the ground, but you can hardly be bothered t notice.

Radioactive Ruins Hell Bomb Glow
Some things are better kept alive.
Release 1 / Serial number 120502 / Inform v6.32 Library 6/11 SD

Hell
Once you had a dream that a fox named Beezelpup took you under his wing with scorn. Sometimes the mask of acceptance isn't wrong but you forgot your last name. Z-machines dream of electric eels and orange peels. There is a second life in the south.

You can see a Beezelpup and a Black Hole here.

>south
Second Life
Stelarc invites you for tea with the metaorchestra. You are greeted by third ears and electrodes. Pauline Oliveros uses skype and chant over old records. Third life is a dead scene. You plan to drink yourself in the west.
Beezelpup is non fiction

>east
You can't go that way.
Beezelpup falls asleep.

>say hello
(to yourself)
There is no reply.
Beezelpup falls asleep.

>west
Beer Bottle
Death from this angle is much more agreeable. You haven't the faintest idea why you'd ever leave. Northern sun.
Beezelpup is non fiction

>north
Desert Sand Hour Glass
One grain of sand is worth two opinions on the matter at hand. Once you got a really good deal at a garage sale on some knock of Transformers toys. You didn't mind that they were old, it was the best day of your life, for the day.
Beezelpup says, "You must give up hope."

* * *

Tentacle-laden goat eyes drag themselves on the ground, but you can hardly be bothered t notice.

Radioactive Ruins Hell Bomb Glow
Some things are better kept alive.
Release 1 / Serial number 120502 / Inform v6.32 Library 6/11 SD

Hell
Once you had a dream that a fox named Beezelpup took you under his wing with scorn. Sometimes the mask of acceptance isn't wrong but you forgot your last name. Z-machines dream of electric eels and orange peels. There is a second life in the south.

You can see a Beezelpup and a Black Hole here.

>look
Hell
Once you had a dream that a fox named Beezelpup took you under his wing with scorn. Sometimes the mask of acceptance isn't wrong but you forgot your last name. Z-machines dream of electric eels and orange peels. There is a second life in the south

You can see a Beezelpup and a Black Hole here.
Beezelpup mentions, "I'm going to eat your soul someday, you know."

>north
You can't go that way.

>south
"Second Life"
Stelarc invites you for tea with the metaorchestra. You are greeted by third ears and electrodes. Pauline Oliveros uses skype and chant over old records. Was second life always this way?

>east
You can't go that way.

>west
You can't go that way.

* * *

>look
Hell
Once you had a dream that a fox named Beezelpup took you under his wing with scorn. Sometimes the mask of acceptance isn't wrong but you forgot your last name. Z-machines dream of electric eels and orange peels. There is a second life in the south

You can see a Beezelpup and a Black Hole here.
Beezelpup mentions, "I'm going to eat your soul someday, you know."

>south
Second Life
Stelarc invites you for tea with the metaorchestra. You are greeted by third ears and electrodes. Pauline Oliveros uses skype and chant over old records. Third life is a dead scene. You plan to drink yourself in the west.
Beezelpup says, "Sometimes you wish you could die. Well I don't, but you do."

>look
Second Life
Stelarc invites you for tea with the metaorchestra. You are greeted by third ears and electrodes. Pauline Oliveros uses skype and chant over old records. Third life is a dead scene. You plan to drink yourself in the west.
Beezelpup mentions, "I'm going to eat your soul someday, you know."

>west
Beer Bottle
Death from this angle is much more agreeable. You haven't the faintest idea why you'd ever leave. Northern sun.
Beezelpup says, "You must give up hope."

>north
Desert Sand Hour Glass
One grain of sand is worth two opinions on the matter at hand. Once you got a really good deal at a garage sale on some knock of Transformers toys. You didn't mind that they were old, it was the best day of your life, for the day.
Beezelpup falls asleep.